+========+
|        |
|        |
|        |
|  444   |
|  4     |
|  4     |
| 343    |
+========+========+
| 343    |  22222 |
|  4     |  2   2 |
|  4     |  2   2 |
|  4     |  2   2 |
|  4    3|3 22 22 |
|  444444|44444   |
|       3|3   4   |
|        |    4   |
+========+========+
